11111111111111111111
1CCCCC00000000000E01
11111100000000111111
10000000CCCC00000001
1CCC0000111100000001
1111000000000CCCCCC1
10000000000001111111
1P000000000000000001
11111111111111111111